Region,Product,Date,Customer,Quantity,Revenue,COGS,Profit
East,XYZ,7/24/2004,QRS INC.,1000,22810,10220,12590
Central,DEF,7/25/2004,"JKL, CO",100,2257,984,1273
East,ABC,7/25/2004,"JKL, CO",500,10245,4235,6010
Central,XYZ,7/26/2004,"WXY, CO",500,11240,5110,6130
East,XYZ,7/27/2004,"FGH, CO",400,9152,4088,5064
Central,XYZ,7/27/2004,"WXY, CO",400,9204,4088,5116
East,DEF,7/27/2004,RST INC.,800,18552,7872,10680
Central,ABC,7/28/2004,EFG S.A.,400,6860,3388,3472
East,DEF,7/30/2004,"UVW, INC.",1000,21730,9840,11890
West,XYZ,7/30/2004,"FGH, CO",600,13806,6132,7674
East,ABC,7/30/2004,FGH LTD.,400,8456,3388,5068
East,XYZ,8/1/2004,MNO S.A.,900,21015,9198,11817
Central,ABC,8/1/2004,FGH LTD.,800,16416,6776,9640
Central,XYZ,8/2/2004,"OPQ, INC.",900,21438,9198,12240
East,XYZ,8/2/2004,"WXY, CO",900,21465,9198,12267
West,XYZ,8/4/2004,"WXY, CO",400,9144,4088,5056
Central,ABC,8/4/2004,EFG S.A.,300,6267,2541,3726
Central,ABC,8/6/2004,TUV GMBH,100,1740,847,893
West,ABC,8/6/2004,"OPQ, INC.",1000,19110,8470,10640
East,XYZ,8/6/2004,TUV GMBH,100,2401,1022,1379
East,ABC,8/7/2004,"JKL, CO",500,9345,4235,5110
East,ABC,8/8/2004,LMN PTY LTD,600,11628,5082,6546
Central,XYZ,8/8/2004,"OPQ, INC.",900,21888,9198,12690
East,XYZ,8/9/2004,"DEF, LLC",300,5961,2952,3009
West,DEF,8/11/2004,"JKL, CO",100,2042,984,1058
Central,ABC,8/12/2004,LMN PTY LTD,900,17505,7623,9882
West,ABC,8/13/2004,RST INC.,200,3552,1694,1858
East,ABC,8/13/2004,LMN LTD.,800,14440,6776,7664
West,XYZ,8/13/2004,"DEF, LLC",300,7032,2952,4080
West,XYZ,8/14/2004,"DEF, LLC",300,6735,2952,3783
East,XYZ,8/14/2004,"JKL, CO",100,2401,1022,1379
West,ABC,8/15/2004,FGH LTD.,800,14592,6776,7816
East,XYZ,8/15/2004,"DEF, LLC",400,8164,3388,4776
West,ABC,8/16/2004,"OPQ, INC.",300,6207,2541,3666
East,ABC,8/16/2004,EFG S.A.,600,12606,5082,7524
East,XYZ,8/17/2004,"DEF, LLC",300,6240,2952,3288
Central,ABC,8/17/2004,LMN PTY LTD,1000,20770,8470,12300
East,ABC,8/18/2004,EFG S.A.,400,8128,3388,4740
West,XYZ,8/19/2004,"OPQ, INC.",100,1882,847,1035
Central,XYZ,8/19/2004,"OPQ, INC.",100,2231,984,1247
Central,ABC,8/19/2004,"WXY, CO",500,10445,4235,6210
East,XYZ,8/21/2004,LMN PTY LTD,100,2054,984,1070
East,ABC,8/21/2004,"OPQ, INC.",800,14224,6776,7448
East,ABC,8/21/2004,"FGH, CO",400,7136,3388,3748
East,DEF,8/21/2004,FGH LTD.,700,17150,6888,10262
East,DEF,8/22/2004,"OPQ, INC.",300,6714,2952,3762
Central,XYZ,8/22/2004,TUV GMBH,400,10044,4088,5956
West,ABC,8/23/2004,LMN PTY LTD,1000,19250,8470,10780
East,ABC,8/23/2004,FGH LTD.,800,15640,6776,8864
East,DEF,8/24/2004,FGH LTD.,600,12672,5904,6768
West,ABC,8/24/2004,"OPQ, INC.",300,5532,2541,2991
East,XYZ,8/24/2004,"DEF, LLC",200,4740,1968,2772
East,XYZ,8/25/2004,"DEF, LLC",100,2012,847,1165
West,DEF,8/26/2004,"JKL, CO",800,17160,7872,9288
Central,XYZ,8/28/2004,"DEF, LLC",700,13314,5929,7385
Central,DEF,8/29/2004,"WXY, CO",200,4280,1968,2312
East,DEF,8/29/2004,"WXY, CO",900,21708,8856,12852
West,ABC,8/30/2004,EFG S.A.,1000,19890,8470,11420
Central,ABC,8/31/2004,LMN PTY LTD,100,1817,847,970
East,ABC,8/31/2004,"JKL, CO",300,6045,2541,3504
Central,ABC,9/1/2004,FGH LTD.,300,5157,2541,2616
Central,ABC,9/1/2004,"OPQ, INC.",400,7180,3388,3792
Central,XYZ,9/3/2004,TUV GMBH,100,2487,1022,1465
East,DEF,9/5/2004,LMN PTY LTD,600,12798,5904,6894
East,DEF,9/6/2004,LMN PTY LTD,700,13867,6888,6979
East,ABC,9/7/2004,"OPQ, INC.",100,2066,847,1219
East,XYZ,9/8/2004,"GHI, CO",800,16936,8176,8760
East,DEF,9/8/2004,QRS INC.,200,4742,1968,2774
East,XYZ,9/9/2004,"DEF, LLC",600,11430,5082,6348
West,ABC,9/9/2004,FGH LTD.,200,3876,1694,2182
West,ABC,9/10/2004,"OPQ, INC.",1000,20250,8470,11780
Central,XYZ,9/11/2004,"WXY, CO",100,2095,1022,1073
West,DEF,9/11/2004,EFG S.A.,400,9088,3936,5152
Central,ABC,9/11/2004,"OPQ, INC.",500,10385,4235,6150
West,XYZ,9/11/2004,FGH LTD.,1000,25080,10220,14860
East,ABC,9/12/2004,HIJ GMBH,400,7152,3388,3764
Central,XYZ,9/12/2004,"DEF, LLC",600,11124,5082,6042
West,ABC,9/12/2004,QRS INC.,300,5700,2541,3159
Central,XYZ,9/12/2004,"OPQ, INC.",1000,23810,10220,13590
Central,DEF,9/12/2004,"WXY, CO",800,18504,7872,10632
Central,DEF,9/14/2004,QRS INC.,600,12282,5904,6378
Central,XYZ,9/15/2004,"OPQ, INC.",500,11525,5110,6415
East,XYZ,9/16/2004,"WXY, CO",1000,20940,10220,10720
East,XYZ,9/17/2004,QRS INC.,100,2257,984,1273
West,ABC,9/18/2004,FGH LTD.,700,12145,5929,6216
Central,XYZ,9/18/2004,QRS INC.,1000,22680,10220,12460
East,DEF,9/18/2004,QRS INC.,600,13206,5904,7302
Central,DEF,9/18/2004,MNO CORP,900,20610,8856,11754
Central,XYZ,9/18/2004,EFG S.A.,700,17367,7154,10213
Central,XYZ,9/18/2004,"OPQ, INC.",1000,25140,10220,14920
Central,ABC,9/19/2004,QRS INC.,900,16209,7623,8586
East,DEF,9/19/2004,"OPQ, INC.",400,8708,3936,4772
Central,XYZ,9/19/2004,LMN INC.,200,4614,2044,2570
Central,ABC,9/19/2004,"JKL, CO",600,11922,5082,6840
East,XYZ,9/20/2004,"JKL, CO",1000,20490,10220,10270
East,XYZ,9/20/2004,FGH LTD.,900,21456,9198,12258
West,XYZ,9/21/2004,"OPQ, INC.",500,10445,5110,5335
East,XYZ,9/23/2004,"WXY, CO",400,8620,4088,4532
East,DEF,9/24/2004,EFG S.A.,500,11860,4920,6940
West,DEF,9/24/2004,"WXY, CO",600,14472,5904,8568
Central,XYZ,9/25/2004,"OPQ, INC.",200,4262,2044,2218
West,ABC,9/26/2004,VWX GMBH,700,12474,5929,6545
East,ABC,9/26/2004,HIJ GMBH,800,14984,6776,8208
Central,ABC,9/26/2004,QRS INC.,200,4010,1694,2316
East,XYZ,9/27/2004,FGH LTD.,100,2004,984,1020
West,XYZ,9/27/2004,"DEF, LLC",500,10155,4235,5920
East,XYZ,9/28/2004,"FGH, CO",100,2358,984,1374
West,XYZ,9/28/2004,FGH LTD.,200,4754,1968,2786
Central,XYZ,9/29/2004,FGH LTD.,500,12505,5110,7395
Central,DEF,9/30/2004,"OPQ, INC.",900,19503,8856,10647
West,XYZ,10/1/2004,"JKL, CO",100,2309,1022,1287
East,XYZ,10/2/2004,MNO S.A.,100,2178,1022,1156
West,ABC,10/3/2004,FGH LTD.,100,1704,847,857
East,ABC,10/3/2004,EFG S.A.,100,1819,847,972
East,XYZ,10/3/2004,EFG S.A.,100,1957,847,1110
West,XYZ,10/3/2004,EFG S.A.,300,7305,3066,4239
Central,XYZ,10/4/2004,"DEF, LLC",200,4124,2044,2080
East,XYZ,10/4/2004,"OPQ, INC.",500,10935,5110,5825
West,XYZ,10/4/2004,FGH LTD.,100,2106,984,1122
East,XYZ,10/4/2004,"FGH, CO",100,1819,847,972
West,XYZ,10/4/2004,EFG S.A.,500,11965,5110,6855
Central,XYZ,10/4/2004,LMN PTY LTD,1000,24430,10220,14210
West,XYZ,10/6/2004,HIJ GMBH,400,9240,4088,5152
East,XYZ,10/6/2004,FGH LTD.,100,2343,1022,1321
East,DEF,10/6/2004,QRS INC.,200,4526,1968,2558
East,ABC,10/6/2004,MNO CORP,400,8116,3388,4728
West,XYZ,10/6/2004,FGH LTD.,200,4948,2044,2904
West,XYZ,10/6/2004,VWX GMBH,200,4866,1968,2898
Central,XYZ,10/7/2004,LMN PTY LTD,900,18783,9198,9585
Central,XYZ,10/8/2004,"OPQ, INC.",200,3856,1694,2162
East,DEF,10/8/2004,EFG S.A.,500,11695,4920,6775
East,XYZ,10/9/2004,"DEF, LLC",100,2272,984,1288
Central,ABC,10/9/2004,"OPQ, INC.",800,16696,6776,9920
East,XYZ,10/9/2004,"DEF, LLC",100,2547,1022,1525
Central,XYZ,10/10/2004,"OPQ, INC.",200,3552,1694,1858
East,ABC,10/10/2004,"WXY, CO",400,7132,3388,3744
West,DEF,10/10/2004,QRS INC.,100,2157,984,1173
East,XYZ,10/10/2004,"DEF, LLC",200,4010,1694,2316
East,XYZ,10/11/2004,"WXY, CO",200,4784,2044,2740
West,XYZ,10/12/2004,"JKL, CO",400,8732,4088,4644
East,XYZ,10/12/2004,"WXY, CO",100,2213,1022,1191
West,XYZ,10/12/2004,TUV GMBH,300,6765,3066,3699
West,DEF,10/13/2004,LMN PTY LTD,800,15856,7872,7984
Central,ABC,10/13/2004,"OPQ, INC.",300,5355,2541,2814
Central,ABC,10/14/2004,"OPQ, INC.",200,3756,1694,2062
West,DEF,10/14/2004,"OPQ, INC.",1000,23820,9840,13980
Central,XYZ,10/14/2004,RST INC.,100,2484,1022,1462
East,DEF,10/15/2004,FGH LTD.,1000,20090,9840,10250
Central,DEF,10/15/2004,"WXY, CO",200,4472,1968,2504
Central,ABC,10/16/2004,FGH LTD.,700,11858,5929,5929
Central,XYZ,10/16/2004,QRS INC.,1000,23090,10220,12870
Central,ABC,10/18/2004,FGH LTD.,300,5358,2541,2817
West,ABC,10/18/2004,FGH LTD.,500,9855,4235,5620
Central,DEF,10/18/2004,TUV GMBH,900,21357,8856,12501
East,XYZ,10/19/2004,"JKL, CO",200,4722,2044,2678
Central,XYZ,10/20/2004,LMN PTY LTD,100,2058,1022,1036
West,DEF,10/20/2004,"WXY, CO",800,16016,7872,8144
East,DEF,10/20/2004,"OPQ, INC.",800,17240,7872,9368
Central,XYZ,10/20/2004,QRS INC.,200,4192,1694,2498
West,XYZ,10/21/2004,"DEF, LLC",100,1819,847,972
Central,XYZ,10/21/2004,QRS INC.,600,13542,6132,7410
West,ABC,10/22/2004,RST PTY LTD,300,5859,2541,3318
Central,XYZ,10/22/2004,TUV GMBH,600,14448,6132,8316
East,ABC,10/23/2004,TUV GMBH,300,5370,2541,2829
West,XYZ,10/23/2004,EFG S.A.,200,4472,1968,2504
East,XYZ,10/23/2004,HIJ GMBH,200,5002,2044,2958
Central,XYZ,10/24/2004,"DEF, LLC",300,7233,2952,4281
East,XYZ,10/25/2004,FGH LTD.,700,15435,7154,8281
East,XYZ,10/25/2004,"DEF, LLC",400,8632,3936,4696
East,XYZ,10/25/2004,"DEF, LLC",300,6588,2952,3636
West,ABC,10/25/2004,QRS INC.,400,7752,3388,4364
East,XYZ,10/25/2004,QRS INC.,300,6267,2541,3726
West,XYZ,10/25/2004,VWX GMBH,800,20408,8176,12232
West,XYZ,10/26/2004,"DEF, LLC",100,2178,1022,1156
Central,XYZ,10/26/2004,EFG S.A.,200,4286,1968,2318
West,ABC,10/26/2004,LMN PTY LTD,500,9575,4235,5340
West,XYZ,10/26/2004,"JKL, CO",100,2466,1022,1444
West,XYZ,10/26/2004,"FGH, CO",100,2484,1022,1462
East,XYZ,10/27/2004,FGH LTD.,100,2272,984,1288
Central,ABC,10/28/2004,"WXY, CO",300,5886,2541,3345
Central,ABC,10/28/2004,QRS INC.,500,10460,4235,6225
East,ABC,10/28/2004,HIJ GMBH,700,14686,5929,8757
Central,XYZ,10/31/2004,"OPQ, INC.",200,4388,2044,2344
Central,XYZ,10/31/2004,QRS INC.,800,18344,8176,10168
East,XYZ,10/31/2004,"OPQ, INC.",200,4492,1968,2524
East,ABC,10/31/2004,FGH LTD.,400,8132,3388,4744
East,XYZ,10/31/2004,"DEF, LLC",500,12095,4920,7175
East,XYZ,11/1/2004,EFG S.A.,900,19539,9198,10341
West,DEF,11/2/2004,"WXY, CO",400,8776,3936,4840
West,ABC,11/2/2004,"WXY, CO",300,6063,2541,3522
East,XYZ,11/3/2004,QRS INC.,200,4614,2044,2570
East,ABC,11/3/2004,"WXY, CO",600,11598,5082,6516
East,DEF,11/3/2004,"OPQ, INC.",900,20403,8856,11547
East,XYZ,11/3/2004,RST INC.,100,2066,847,1219
Central,ABC,11/4/2004,LMN PTY LTD,400,8016,3388,4628
East,ABC,11/4/2004,BCD LTD.,600,14004,5904,8100
East,XYZ,11/4/2004,"DEF, LLC",100,2538,1022,1516
West,ABC,11/5/2004,QRS INC.,800,14216,6776,7440
West,XYZ,11/5/2004,"DEF, LLC",200,4186,1968,2218
West,XYZ,11/8/2004,"OPQ, INC.",200,3418,1694,1724
Central,XYZ,11/8/2004,"WXY, CO",200,3802,1694,2108
East,XYZ,11/10/2004,"JKL, CO",1000,21880,10220,11660
East,ABC,11/10/2004,FGH LTD.,900,17172,7623,9549
Central,XYZ,11/10/2004,RST PTY LTD,200,4948,2044,2904
Central,XYZ,11/11/2004,FGH LTD.,1000,20670,10220,10450
Central,XYZ,11/11/2004,"DEF, LLC",300,6660,3066,3594
West,ABC,11/12/2004,"OPQ, INC.",400,7376,3388,3988
Central,XYZ,11/12/2004,"OPQ, INC.",700,15834,7154,8680
West,XYZ,11/12/2004,"WXY, CO",300,6867,3066,3801
East,DEF,11/13/2004,QRS INC.,100,2457,984,1473
East,XYZ,11/14/2004,"DEF, LLC",300,5439,2541,2898
West,XYZ,11/14/2004,RST INC.,800,17728,8176,9552
Central,DEF,11/15/2004,"GHI, CO",1000,20950,9840,11110
Central,XYZ,11/15/2004,"OPQ, INC.",200,4470,1968,2502
East,DEF,11/15/2004,"OPQ, INC.",500,11435,4920,6515
Central,XYZ,11/15/2004,EFG S.A.,100,1982,847,1135
Central,ABC,11/16/2004,QRS INC.,400,7852,3388,4464
Central,XYZ,11/17/2004,FGH LTD.,1000,22530,10220,12310
Central,XYZ,11/17/2004,FGH LTD.,200,4740,1968,2772
Central,ABC,11/17/2004,"OPQ, INC.",600,12360,5082,7278
East,XYZ,11/18/2004,FGH LTD.,200,4132,1968,2164
East,XYZ,11/18/2004,"WXY, CO",100,1842,847,995
East,XYZ,11/18/2004,QRS INC.,1000,25060,10220,14840
Central,DEF,11/19/2004,QRS INC.,900,18990,8856,10134
East,XYZ,11/19/2004,XYZ S.A.,800,18264,8176,10088
West,ABC,11/19/2004,"WXY, CO",300,6069,2541,3528
East,XYZ,11/20/2004,TUV GMBH,200,4124,2044,2080
West,DEF,11/21/2004,TUV GMBH,300,6018,2952,3066
Central,ABC,11/21/2004,QRS INC.,200,3802,1694,2108
East,ABC,11/21/2004,TUV GMBH,1000,20310,8470,11840
Central,DEF,11/21/2004,CDE INC.,800,19520,7872,11648
Central,XYZ,11/22/2004,LMN PTY LTD,200,3942,1968,1974
Central,XYZ,11/22/2004,"JKL, CO",100,1740,847,893
Central,XYZ,11/22/2004,"DEF, LLC",100,1878,847,1031
West,XYZ,11/22/2004,TUV GMBH,1000,25310,10220,15090
West,XYZ,11/23/2004,"OPQ, INC.",100,2029,984,1045
West,DEF,11/23/2004,"JKL, CO",200,4378,1968,2410
West,XYZ,11/23/2004,HIJ GMBH,800,19288,8176,11112
Central,DEF,11/25/2004,FGH LTD.,700,15407,6888,8519
West,XYZ,11/25/2004,HIJ GMBH,300,6867,3066,3801
West,XYZ,11/25/2004,TUV GMBH,300,5700,2541,3159
East,ABC,11/25/2004,TUV GMBH,800,15592,6776,8816
Central,ABC,11/26/2004,"OPQ, INC.",1000,18290,8470,9820
Central,XYZ,11/27/2004,LMN PTY LTD,500,10400,5110,5290
West,DEF,11/27/2004,HIJ GMBH,400,8052,3936,4116
West,XYZ,11/27/2004,"WXY, CO",300,5457,2541,2916
East,ABC,11/27/2004,TUV GMBH,100,1842,847,995
East,ABC,11/27/2004,TUV GMBH,600,12318,5082,7236
West,DEF,11/28/2004,"OPQ, INC.",800,17544,7872,9672
East,ABC,11/28/2004,QRS INC.,100,1982,847,1135
East,DEF,11/29/2004,EFG S.A.,700,16765,6888,9877
West,XYZ,11/30/2004,LMN PTY LTD,300,6159,2952,3207
Central,XYZ,11/30/2004,LMN PTY LTD,300,6789,3066,3723
East,XYZ,11/30/2004,"OPQ, INC.",200,3876,1694,2182
Central,XYZ,12/1/2004,"DEF, LLC",500,8785,4235,4550
Central,DEF,12/1/2004,HIJ GMBH,300,7245,2952,4293
Central,XYZ,12/2/2004,"DEF, LLC",500,11000,5110,5890
East,DEF,12/2/2004,"OPQ, INC.",700,16772,6888,9884
East,ABC,12/3/2004,HIJ GMBH,500,9155,4235,4920
East,ABC,12/3/2004,"WXY, CO",500,9380,4235,5145
East,XYZ,12/3/2004,FGH LTD.,300,5859,2541,3318
East,XYZ,12/3/2004,LMN PTY LTD,200,4742,1968,2774
Central,XYZ,12/3/2004,"OPQ, INC.",500,12625,5110,7515
East,DEF,12/3/2004,FGH LTD.,400,9760,3936,5824
West,XYZ,12/3/2004,"OPQ, INC.",100,2111,847,1264
East,ABC,12/4/2004,"GHI, CO",500,9635,4235,5400
East,XYZ,12/5/2004,LMN PTY LTD,200,4280,1968,2312
East,XYZ,12/5/2004,QRS INC.,400,9156,4088,5068
East,XYZ,12/5/2004,LMN LTD.,100,2409,984,1425
West,DEF,12/6/2004,HIJ GMBH,300,6156,2952,3204
Central,XYZ,12/6/2004,FGH LTD.,200,3922,1694,2228
Central,XYZ,12/7/2004,LMN PTY LTD,100,1836,847,989
Central,XYZ,12/8/2004,"WXY, CO",500,10385,5110,5275
East,XYZ,12/8/2004,"DEF, LLC",300,6240,2952,3288
East,DEF,12/9/2004,VWX GMBH,900,17757,8856,8901
Central,DEF,12/10/2004,"JKL, CO",700,14203,6888,7315
West,XYZ,12/10/2004,MNO S.A.,200,4846,2044,2802
East,XYZ,12/10/2004,"DEF, LLC",300,6309,2541,3768
East,XYZ,12/11/2004,"DEF, LLC",100,1741,847,894
Central,XYZ,12/11/2004,RST INC.,300,5358,2541,2817
Central,XYZ,12/11/2004,"WXY, CO",100,1817,847,970
East,XYZ,12/11/2004,"JKL, CO",100,1861,847,1014
East,ABC,12/11/2004,"WXY, CO",600,11208,5082,6126
West,XYZ,12/11/2004,LMN PTY LTD,600,14634,6132,8502
Central,DEF,12/12/2004,TUV GMBH,500,10195,4920,5275
Central,XYZ,12/12/2004,"DEF, LLC",100,2149,1022,1127
West,ABC,12/12/2004,"UVW, INC.",700,13853,5929,7924
West,XYZ,12/13/2004,"WXY, CO",100,2149,1022,1127
West,ABC,12/13/2004,FGH LTD.,700,12803,5929,6874
East,DEF,12/13/2004,QRS INC.,200,4474,1968,2506
East,ABC,12/13/2004,"JKL, CO",200,4012,1694,2318
East,XYZ,12/13/2004,QRS INC.,100,2487,1022,1465
West,XYZ,12/14/2004,"DEF, LLC",200,4388,2044,2344
Central,ABC,12/14/2004,FGH LTD.,600,11700,5082,6618
East,DEF,12/14/2004,"OPQ, INC.",400,7944,3388,4556
East,XYZ,12/14/2004,"DEF, LLC",100,2319,984,1335
West,XYZ,12/14/2004,QRS INC.,200,4012,1694,2318
West,ABC,12/15/2004,"WXY, CO",300,5094,2541,2553
East,XYZ,12/16/2004,"DEF, LLC",600,12048,5904,6144
East,XYZ,12/16/2004,XYZ S.A.,400,7152,3388,3764
East,XYZ,12/16/2004,"OPQ, INC.",300,7032,3066,3966
East,XYZ,12/18/2004,EFG S.A.,700,14469,7154,7315
Central,DEF,12/18/2004,QRS INC.,800,16264,7872,8392
East,XYZ,12/18/2004,"GHI, CO",200,4262,2044,2218
East,ABC,12/18/2004,FGH LTD.,200,3632,1694,1938
East,XYZ,12/19/2004,"UVW, INC.",100,2157,984,1173
West,XYZ,12/19/2004,"DEF, LLC",900,17964,7623,10341
Central,XYZ,12/20/2004,FGH LTD.,300,6660,3066,3594
West,ABC,12/20/2004,TUV GMBH,700,13412,5929,7483
West,DEF,12/20/2004,"JKL, CO",400,7752,3388,4364
East,DEF,12/20/2004,FGH LTD.,700,16408,6888,9520
Central,XYZ,12/20/2004,FGH LTD.,300,6063,2541,3522
Central,XYZ,12/20/2004,QRS INC.,500,12550,5110,7440
Central,XYZ,12/21/2004,"WXY, CO",900,18918,9198,9720
West,DEF,12/21/2004,TUV GMBH,800,17056,7872,9184
East,XYZ,12/21/2004,"OPQ, INC.",800,19152,8176,10976
Central,XYZ,12/22/2004,QRS INC.,200,4282,1968,2314
West,XYZ,12/22/2004,RST INC.,100,1913,847,1066
Central,ABC,12/22/2004,FGH LTD.,700,13986,5929,8057
East,DEF,12/23/2004,FGH LTD.,400,8560,4088,4472
East,XYZ,12/23/2004,"DEF, LLC",300,7167,3066,4101
Central,DEF,12/24/2004,EFG S.A.,1000,20480,9840,10640
East,XYZ,12/24/2004,HIJ GMBH,1000,23990,10220,13770
East,XYZ,12/25/2004,LMN PTY LTD,1000,22020,10220,11800
West,XYZ,12/25/2004,RST INC.,400,8456,3388,5068
Central,XYZ,12/27/2004,"WXY, CO",100,2042,984,1058
Central,XYZ,12/27/2004,"OPQ, INC.",200,4264,2044,2220
East,DEF,12/28/2004,"WXY, CO",400,8464,3936,4528
East,DEF,12/28/2004,VWX PTY LTD,200,4282,1968,2314
Central,XYZ,12/28/2004,XYZ GMBH,400,9064,4088,4976
East,ABC,12/29/2004,LMN PTY LTD,900,18072,7623,10449
Central,XYZ,12/29/2004,EFG S.A.,500,12135,5110,7025
West,DEF,12/29/2004,"OPQ, INC.",400,9816,4088,5728
East,ABC,12/30/2004,TUV GMBH,800,16288,6776,9512
Central,XYZ,12/30/2004,LMN PTY LTD,100,2055,847,1208
Central,DEF,12/31/2004,EFG S.A.,200,4286,1968,2318
East,XYZ,12/31/2004,EFG S.A.,200,4484,1968,2516
Central,XYZ,12/31/2004,"OPQ, INC.",100,2457,984,1473
East,XYZ,1/1/2005,EFG S.A.,300,5532,2541,2991
Central,DEF,1/1/2005,EFG S.A.,800,17944,7872,10072
Central,DEF,1/2/2005,LMN PTY LTD,400,8052,3936,4116
East,XYZ,1/2/2005,"JKL, CO",500,10650,5110,5540
East,DEF,1/2/2005,"OPQ, INC.",300,6477,2952,3525
Central,DEF,1/2/2005,FGH LTD.,400,8776,3936,4840
West,XYZ,1/3/2005,"DEF, LLC",600,10404,5082,5322
East,ABC,1/3/2005,"JKL, CO",1000,19630,8470,11160
Central,XYZ,1/3/2005,FGH LTD.,100,2466,1022,1444
East,XYZ,1/4/2005,TUV GMBH,300,5094,2541,2553
West,ABC,1/4/2005,EFG S.A.,500,8780,4235,4545
East,XYZ,1/4/2005,TUV GMBH,400,8620,4088,4532
Central,ABC,1/4/2005,"WXY, CO",700,12838,5929,6909
East,XYZ,1/4/2005,"JKL, CO",100,2221,984,1237
Central,XYZ,1/4/2005,LMN INC.,200,4158,1694,2464
Central,XYZ,1/4/2005,"WXY, CO",100,2108,847,1261
Central,DEF,1/5/2005,FGH LTD.,500,9155,4235,4920
West,ABC,1/5/2005,QRS INC.,200,3856,1694,2162
East,XYZ,1/5/2005,FGH LTD.,300,7593,3066,4527
West,XYZ,1/7/2005,EFG S.A.,200,4412,1968,2444
East,ABC,1/8/2005,"WXY, CO",700,13874,5929,7945
Central,DEF,1/9/2005,LMN LTD.,1000,22140,9840,12300
West,XYZ,1/9/2005,EFG S.A.,100,1968,847,1121
East,DEF,1/10/2005,LMN PTY LTD,500,8780,4235,4545
Central,XYZ,1/10/2005,QRS INC.,300,6438,3066,3372
East,XYZ,1/11/2005,"JKL, CO",700,15988,7154,8834
Central,XYZ,1/13/2005,QRS INC.,200,4474,1968,2506
Central,ABC,1/13/2005,EFG S.A.,500,10330,4235,6095
Central,DEF,1/14/2005,TUV GMBH,1000,20020,9840,10180
West,XYZ,1/14/2005,"DEF, LLC",100,1882,847,1035
East,XYZ,1/14/2005,TUV GMBH,100,2319,984,1335
Central,ABC,1/15/2005,BCD LTD.,200,4060,1968,2092
West,XYZ,1/15/2005,RST PTY LTD,300,6156,2952,3204
East,XYZ,1/15/2005,"OPQ, INC.",100,1877,847,1030
Central,DEF,1/15/2005,QRS INC.,100,2221,984,1237
Central,DEF,1/16/2005,HIJ GMBH,800,15856,7872,7984
West,ABC,1/16/2005,"WXY, CO",800,15400,6776,8624
Central,XYZ,1/16/2005,"DEF, LLC",700,13734,5929,7805
West,DEF,1/16/2005,QRS INC.,700,16219,6888,9331
Central,XYZ,1/16/2005,RST PTY LTD,300,7569,3066,4503
East,XYZ,1/17/2005,EFG S.A.,100,1795,847,948
Central,XYZ,1/17/2005,"DEF, LLC",400,8804,4088,4716
Central,XYZ,1/17/2005,QRS INC.,400,9088,3936,5152
Central,DEF,1/17/2005,"UVW, INC.",200,4754,1968,2786
East,XYZ,1/18/2005,"DEF, LLC",300,6477,2952,3525
West,XYZ,1/18/2005,"DEF, LLC",500,9575,4235,5340
West,XYZ,1/18/2005,LMN PTY LTD,100,2410,984,1426
West,XYZ,1/19/2005,FGH LTD.,300,6069,2541,3528
East,ABC,1/19/2005,BCD LTD.,300,7053,2952,4101
Central,XYZ,1/20/2005,"DEF, LLC",100,2231,984,1247
East,XYZ,1/20/2005,"DEF, LLC",500,12425,5110,7315
East,DEF,1/21/2005,"JKL, CO",100,2054,984,1070
West,XYZ,1/22/2005,QRS INC.,300,5532,2541,2991
West,XYZ,1/22/2005,"WXY, CO",400,8708,3936,4772
Central,XYZ,1/22/2005,"WXY, CO",900,21960,9198,12762
East,XYZ,1/22/2005,EFG S.A.,400,9816,4088,5728
West,DEF,1/23/2005,"OPQ, INC.",900,18099,8856,9243
Central,XYZ,1/23/2005,RST S.A.,300,7167,3066,4101
East,XYZ,1/23/2005,"OPQ, INC.",900,22716,9198,13518
East,ABC,1/23/2005,TUV GMBH,200,4192,1694,2498
East,XYZ,1/24/2005,TUV GMBH,900,19062,9198,9864
West,DEF,1/24/2005,MNO S.A.,400,8556,4088,4468
Central,XYZ,1/24/2005,"WXY, CO",300,5370,2541,2829
Central,XYZ,1/24/2005,QRS INC.,300,6789,3066,3723
Central,XYZ,1/25/2005,"DEF, LLC",700,16303,6888,9415
East,XYZ,1/25/2005,"WXY, CO",300,6045,2541,3504
West,XYZ,1/25/2005,FGH LTD.,300,7593,3066,4527
East,XYZ,1/27/2005,"OPQ, INC.",400,8580,4088,4492
Central,XYZ,1/28/2005,"DEF, LLC",400,9704,4088,5616
East,XYZ,1/28/2005,"DEF, LLC",900,21168,8856,12312
Central,DEF,1/28/2005,FGH LTD.,500,12270,4920,7350
Central,XYZ,1/29/2005,"OPQ, INC.",200,3756,1694,2062
East,XYZ,1/29/2005,FGH LTD.,300,7233,2952,4281
West,XYZ,1/29/2005,"DEF, LLC",500,12760,5110,7650
Central,XYZ,1/30/2005,EFG S.A.,100,1704,847,857
East,XYZ,1/30/2005,QRS INC.,200,4060,1968,2092
West,XYZ,1/30/2005,"GHI, CO",1000,24130,10220,13910
Central,XYZ,1/31/2005,VWX PTY LTD,400,8876,4088,4788
Central,ABC,1/31/2005,"OPQ, INC.",900,17883,7623,10260
West,DEF,1/31/2005,TUV GMBH,500,12625,5110,7515
Central,DEF,2/1/2005,"JKL, CO",400,8204,3936,4268
Central,XYZ,2/1/2005,"OPQ, INC.",200,5002,2044,2958
East,DEF,2/1/2005,QRS INC.,400,8468,3388,5080
Central,XYZ,2/2/2005,"OPQ, INC.",200,4378,1968,2410
East,DEF,2/2/2005,HIJ GMBH,500,9635,4235,5400
Central,DEF,2/2/2005,"OPQ, INC.",400,7852,3388,4464
East,DEF,2/2/2005,EFG S.A.,500,11725,4920,6805
East,DEF,2/3/2005,TUV GMBH,500,10380,5110,5270
West,XYZ,2/3/2005,"WXY, CO",200,4270,1968,2302
Central,XYZ,2/3/2005,"GHI, CO",400,9144,4088,5056
Central,XYZ,2/3/2005,EFG S.A.,900,21366,9198,12168
West,XYZ,2/3/2005,"DEF, LLC",500,11660,4920,6740
East,DEF,2/3/2005,"WXY, CO",900,21555,8856,12699
East,DEF,2/4/2005,RST S.A.,700,14497,6888,7609
Central,XYZ,2/4/2005,QRS INC.,700,15876,7154,8722
East,XYZ,2/4/2005,"WXY, CO",300,6714,2952,3762
East,ABC,2/4/2005,EFG S.A.,300,5967,2541,3426
Central,DEF,2/5/2005,QRS INC.,800,17416,7872,9544
Central,XYZ,2/5/2005,"JKL, CO",200,4902,2044,2858
West,XYZ,2/6/2005,QRS INC.,300,6462,2952,3510
East,XYZ,2/6/2005,HIJ GMBH,1000,25350,10220,15130
East,ABC,2/7/2005,QRS INC.,700,13804,5929,7875
Central,DEF,2/7/2005,EFG S.A.,500,11545,4920,6625
Central,XYZ,2/7/2005,EFG S.A.,200,4902,2044,2858
West,ABC,2/7/2005,UVW INC.,200,4158,1694,2464
Central,XYZ,2/8/2005,QRS INC.,300,6522,2952,3570
East,DEF,2/8/2005,"OPQ, INC.",500,11235,4920,6315
Central,XYZ,2/8/2005,"OPQ, INC.",300,6207,2541,3666
West,DEF,2/8/2005,QRS INC.,500,12575,5110,7465
West,DEF,2/9/2005,TUV GMBH,500,10400,5110,5290
East,XYZ,2/9/2005,"WXY, CO",200,3632,1694,1938
Central,XYZ,2/9/2005,CDE INC.,400,9240,4088,5152
West,XYZ,2/9/2005,"JKL, CO",100,2320,1022,1298
East,XYZ,2/9/2005,MNO CORP,200,4690,2044,2646
West,ABC,2/9/2005,FGH LTD.,600,12684,5082,7602
West,XYZ,2/10/2005,CDE INC.,1000,22840,10220,12620
East,DEF,2/10/2005,"OPQ, INC.",500,11680,5110,6570
West,XYZ,2/11/2005,"DEF, LLC",200,3390,1694,1696
West,XYZ,2/11/2005,TUV GMBH,400,8632,3936,4696
East,ABC,2/11/2005,"OPQ, INC.",1000,18660,8470,10190
West,XYZ,2/11/2005,EFG S.A.,200,4696,1968,2728
East,DEF,2/11/2005,VWX GMBH,400,9484,3936,5548
East,DEF,2/12/2005,"JKL, CO",300,6228,2952,3276
Central,DEF,2/12/2005,TUV GMBH,500,11660,4920,6740
Central,XYZ,2/12/2005,LMN PTY LTD,300,7032,2952,4080
East,XYZ,2/12/2005,FGH LTD.,100,2517,1022,1495
Central,XYZ,2/13/2005,"OPQ, INC.",400,7136,3388,3748
West,XYZ,2/13/2005,LMN PTY LTD,300,6765,3066,3699
West,DEF,2/14/2005,FGH LTD.,500,10475,4920,5555
East,XYZ,2/14/2005,"DEF, LLC",600,13806,6132,7674
East,DEF,2/15/2005,FGH LTD.,800,15816,7872,7944
East,XYZ,2/15/2005,"OPQ, INC.",100,2092,1022,1070
Central,DEF,2/15/2005,"OPQ, INC.",500,10195,4920,5275
East,DEF,2/15/2005,QRS INC.,600,13332,5904,7428
West,XYZ,2/15/2005,"DEF, LLC",100,2028,847,1181
Central,DEF,2/16/2005,"OPQ, INC.",200,4132,1968,2164
Central,XYZ,2/16/2005,TUV GMBH,100,2234,1022,1212
West,XYZ,2/16/2005,RST S.A.,1000,23890,10220,13670
East,DEF,2/17/2005,EFG S.A.,400,8580,4088,4492
Central,XYZ,2/17/2005,TUV GMBH,300,5439,2541,2898
Central,XYZ,2/17/2005,"DEF, LLC",200,4722,2044,2678
West,DEF,2/17/2005,"JKL, CO",600,13866,5904,7962
East,ABC,2/18/2005,"OPQ, INC.",800,13936,6776,7160
East,ABC,2/18/2005,MNO S.A.,1000,17840,8470,9370
East,XYZ,2/18/2005,FGH LTD.,300,5592,2541,3051
East,DEF,2/18/2005,FGH LTD.,700,16170,6888,9282
Central,DEF,2/19/2005,"JKL, CO",300,6159,2952,3207
East,XYZ,2/19/2005,"WXY, CO",600,12984,6132,6852
West,ABC,2/19/2005,MNO CORP,1000,18290,8470,9820
East,DEF,2/19/2005,"JKL, CO",500,11845,4920,6925
West,DEF,2/19/2005,HIJ GMBH,400,8196,3388,4808
Central,ABC,2/20/2005,"OPQ, INC.",300,5508,2541,2967
West,XYZ,2/20/2005,"DEF, LLC",1000,18500,8470,10030
Central,DEF,2/20/2005,LMN PTY LTD,1000,21800,9840,11960
Central,XYZ,2/20/2005,FGH LTD.,300,6588,2952,3636
East,DEF,2/20/2005,TUV GMBH,500,10330,4235,6095
West,XYZ,2/21/2005,"DEF, LLC",600,12048,5904,6144
East,XYZ,2/22/2005,"WXY, CO",200,4380,1968,2412
East,DEF,2/23/2005,LMN PTY LTD,500,10385,5110,5275
Central,XYZ,2/23/2005,"DEF, LLC",900,21159,9198,11961
East,XYZ,2/23/2005,"DEF, LLC",400,9704,4088,5616
West,DEF,2/24/2005,FGH LTD.,500,11525,5110,6415
West,XYZ,2/24/2005,UVW INC.,600,13962,6132,7830
West,ABC,2/24/2005,TUV GMBH,800,15488,6776,8712
East,DEF,2/24/2005,"JKL, CO",500,11295,4920,6375
East,XYZ,2/24/2005,QRS INC.,100,2547,1022,1525
West,ABC,2/25/2005,"OPQ, INC.",200,3418,1694,1724
East,XYZ,2/25/2005,"JKL, CO",300,6732,3066,3666
Central,XYZ,2/25/2005,"DEF, LLC",700,13433,5929,7504
East,XYZ,2/25/2005,"OPQ, INC.",400,8164,3388,4776
East,XYZ,2/26/2005,TUV GMBH,400,7132,3388,3744
Central,XYZ,2/26/2005,FGH LTD.,900,19584,9198,10386
Central,ABC,2/26/2005,HIJ GMBH,800,15288,6776,8512
West,ABC,2/26/2005,FGH LTD.,1000,19530,8470,11060
East,DEF,2/27/2005,XYZ GMBH,200,4380,1968,2412
Central,XYZ,2/27/2005,"WXY, CO",100,2320,1022,1298
East,XYZ,2/28/2005,EFG S.A.,200,4550,2044,2506
Central,DEF,3/1/2005,HIJ GMBH,400,9384,4088,5296
Central,DEF,3/1/2005,QRS INC.,500,11965,5110,6855
Central,XYZ,3/2/2005,"WXY, CO",300,5904,2541,3363
West,XYZ,3/2/2005,"DEF, LLC",300,6138,2541,3597
Central,DEF,3/3/2005,"OPQ, INC.",600,13368,5904,7464
West,XYZ,3/3/2005,"WXY, CO",300,5826,2541,3285
East,XYZ,3/3/2005,HIJ GMBH,200,4846,2044,2802
West,DEF,3/4/2005,TUV GMBH,800,16936,7872,9064
Central,DEF,3/4/2005,"OPQ, INC.",400,8592,3936,4656
Central,XYZ,3/4/2005,QRS INC.,200,4550,2044,2506
Central,XYZ,3/5/2005,"DEF, LLC",500,10550,5110,5440
Central,DEF,3/5/2005,EFG S.A.,500,9380,4235,5145
West,DEF,3/6/2005,EFG S.A.,600,12030,5904,6126
West,XYZ,3/6/2005,FGH LTD.,200,3672,1694,1978
West,DEF,3/6/2005,TUV GMBH,300,6522,2952,3570
East,DEF,3/6/2005,FGH LTD.,600,13866,5904,7962
East,ABC,3/6/2005,QRS INC.,300,6138,2541,3597
West,XYZ,3/7/2005,FGH LTD.,200,4526,1968,2558
West,XYZ,3/7/2005,QRS INC.,300,5967,2541,3426
Central,DEF,3/8/2005,"FGH, CO",200,4270,1968,2302
East,DEF,3/8/2005,"JKL, CO",500,9345,4235,5110
West,XYZ,3/8/2005,HIJ GMBH,400,9384,4088,5296
Central,DEF,3/8/2005,HIJ GMBH,700,17213,6888,10325
East,XYZ,3/9/2005,"DEF, LLC",300,5904,2541,3363
Central,DEF,3/9/2005,QRS INC.,600,14472,5904,8568
East,XYZ,3/10/2005,"DEF, LLC",800,16232,7872,8360
Central,DEF,3/10/2005,LMN PTY LTD,400,8876,4088,4788
Central,XYZ,3/10/2005,QRS INC.,200,4440,2044,2396
West,DEF,3/10/2005,CDE INC.,600,14634,6132,8502
Central,XYZ,3/11/2005,"DEF, LLC",1000,21120,8470,12650
West,XYZ,3/11/2005,QRS INC.,500,12755,5110,7645
East,XYZ,3/12/2005,HIJ GMBH,900,18684,9198,9486
East,ABC,3/12/2005,QRS INC.,100,1836,847,989
West,DEF,3/12/2005,FGH LTD.,200,4470,1968,2502
West,XYZ,3/12/2005,"OPQ, INC.",200,4784,2044,2740
West,DEF,3/12/2005,HIJ GMBH,400,8132,3388,4744
East,DEF,3/13/2005,"OPQ, INC.",500,10760,4920,5840
Central,ABC,3/13/2005,QRS INC.,300,6156,2541,3615
Central,DEF,3/14/2005,EFG S.A.,500,10650,5110,5540
West,DEF,3/14/2005,LMN PTY LTD,900,19989,8856,11133
Central,ABC,3/14/2005,"WXY, CO",800,15544,6776,8768
East,XYZ,3/14/2005,TUV GMBH,600,15006,6132,8874
Central,ABC,3/15/2005,BCD LTD.,500,11530,4920,6610
East,XYZ,3/16/2005,"OPQ, INC.",200,3390,1694,1696
East,DEF,3/16/2005,QRS INC.,600,13332,5904,7428
Central,XYZ,3/16/2005,"DEF, LLC",500,11430,4920,6510
West,DEF,3/16/2005,QRS INC.,100,2409,984,1425
East,XYZ,3/17/2005,"OPQ, INC.",300,6018,2952,3066
East,XYZ,3/17/2005,HIJ GMBH,600,12570,6132,6438
Central,XYZ,3/17/2005,EFG S.A.,300,6438,3066,3372
West,XYZ,3/17/2005,"WXY, CO",400,8744,4088,4656
West,XYZ,3/17/2005,RST PTY LTD,800,17856,8176,9680
East,ABC,3/17/2005,QRS INC.,100,1913,847,1066
East,XYZ,3/18/2005,LMN PTY LTD,900,19368,9198,10170
Central,XYZ,3/18/2005,QRS INC.,900,19593,9198,10395
West,XYZ,3/18/2005,"DEF, LLC",600,12690,5904,6786
Central,DEF,3/18/2005,"UVW, INC.",500,10955,4920,6035
East,XYZ,3/18/2005,EFG S.A.,300,6735,2952,3783
Central,XYZ,3/18/2005,FGH LTD.,400,10044,4088,5956
East,ABC,3/19/2005,CDE INC.,100,1819,847,972
West,ABC,3/19/2005,"JKL, CO",900,18981,7623,11358
Central,XYZ,3/20/2005,"DEF, LLC",800,17160,8176,8984
East,XYZ,3/20/2005,TUV GMBH,500,10990,5110,5880
Central,XYZ,3/20/2005,TUV GMBH,200,4440,2044,2396
West,ABC,3/20/2005,"OPQ, INC.",300,5859,2541,3318
Central,XYZ,3/20/2005,QRS INC.,300,5886,2541,3345
East,ABC,3/20/2005,EFG S.A.,100,2028,847,1181
East,DEF,3/21/2005,"WXY, CO",400,6944,3388,3556
Central,XYZ,3/21/2005,MNO CORP,200,4264,2044,2220
Central,XYZ,3/21/2005,"DEF, LLC",400,8744,4088,4656
East,ABC,3/21/2005,XYZ S.A.,300,5532,2541,2991
Central,ABC,3/21/2005,"JKL, CO",300,6309,2541,3768
West,XYZ,3/22/2005,TUV GMBH,400,8732,4088,4644
West,DEF,3/22/2005,HIJ GMBH,800,18904,7872,11032
West,XYZ,3/22/2005,QRS INC.,500,12575,5110,7465
Central,XYZ,3/23/2005,"OPQ, INC.",300,5355,2541,2814
East,DEF,3/23/2005,EFG S.A.,600,12798,5904,6894
West,DEF,3/23/2005,TUV GMBH,600,13818,6132,7686
West,DEF,3/23/2005,UVW INC.,600,12360,5082,7278
West,XYZ,3/24/2005,HIJ GMBH,300,5961,2952,3009
Central,DEF,3/24/2005,HIJ GMBH,500,10940,5110,5830
Central,DEF,3/24/2005,EFG S.A.,500,9350,4235,5115
West,ABC,3/24/2005,BCD LTD.,800,18072,8176,9896
Central,ABC,3/24/2005,"OPQ, INC.",100,2012,847,1165
West,ABC,3/24/2005,LMN PTY LTD,800,16144,6776,9368
Central,XYZ,3/24/2005,QRS INC.,400,8116,3388,4728
Central,XYZ,3/24/2005,"DEF, LLC",600,14466,5904,8562
Central,XYZ,3/24/2005,"DEF, LLC",700,14686,5929,8757
East,DEF,3/26/2005,FGH LTD.,900,18486,8856,9630
East,XYZ,3/26/2005,"WXY, CO",300,6582,2952,3630
Central,DEF,3/26/2005,FGH LTD.,500,10460,4235,6225
West,ABC,3/27/2005,QRS INC.,500,10295,4235,6060
East,DEF,3/28/2005,FGH LTD.,100,2106,984,1122
East,XYZ,3/28/2005,"DEF, LLC",900,17289,7623,9666
Central,ABC,3/28/2005,QRS INC.,400,7944,3388,4556
West,XYZ,3/29/2005,"JKL, CO",300,5157,2541,2616
West,DEF,3/29/2005,"UVW, INC.",500,11240,5110,6130
East,DEF,3/29/2005,HIJ GMBH,600,13542,6132,7410
West,ABC,3/29/2005,EFG S.A.,100,1957,847,1110
Central,ABC,3/30/2005,TUV GMBH,700,13804,5929,7875
East,DEF,3/30/2005,"JKL, CO",500,11545,4920,6625
East,DEF,3/30/2005,"OPQ, INC.",500,11725,4920,6805
West,DEF,3/31/2005,LMN PTY LTD,400,8284,4088,4196
East,DEF,3/31/2005,MNO S.A.,600,12570,6132,6438
East,DEF,4/1/2005,QRS INC.,600,12480,6132,6348
East,DEF,4/1/2005,UVW INC.,100,2029,984,1045
East,DEF,4/1/2005,"GHI, CO",400,7520,3388,4132
Central,XYZ,4/2/2005,"JKL, CO",600,12936,6132,6804
West,XYZ,4/2/2005,VWX GMBH,300,6228,2952,3276
East,DEF,4/2/2005,TUV GMBH,600,12756,5904,6852
East,DEF,4/2/2005,TUV GMBH,400,9156,4088,5068
Central,DEF,4/2/2005,"JKL, CO",700,15680,6888,8792
Central,DEF,4/2/2005,MNO S.A.,500,11550,4920,6630
Central,DEF,4/3/2005,FGH LTD.,500,10445,5110,5335
Central,XYZ,4/3/2005,FGH LTD.,300,6744,3066,3678
Central,XYZ,4/3/2005,"DEF, LLC",300,5826,2541,3285
East,DEF,4/3/2005,TUV GMBH,400,8016,3388,4628
Central,DEF,4/3/2005,"OPQ, INC.",600,12330,5082,7248
East,DEF,4/4/2005,HIJ GMBH,600,14580,5904,8676
East,XYZ,4/5/2005,LMN PTY LTD,800,20008,8176,11832
Central,XYZ,4/6/2005,LMN PTY LTD,100,2058,1022,1036
Central,XYZ,4/6/2005,LMN PTY LTD,300,6495,3066,3429
East,ABC,4/6/2005,LMN PTY LTD,300,5457,2541,2916
East,DEF,4/6/2005,QRS INC.,600,13566,5904,7662
West,XYZ,4/6/2005,"OPQ, INC.",300,5859,2541,3318
Central,DEF,4/7/2005,EFG S.A.,700,13412,5929,7483
East,XYZ,4/7/2005,"DEF, LLC",600,12330,5082,7248
Central,DEF,4/8/2005,RST S.A.,500,11470,5110,6360
Central,DEF,4/8/2005,"OPQ, INC.",600,12606,5082,7524
West,ABC,4/9/2005,"WXY, CO",100,1741,847,894
East,XYZ,4/9/2005,"DEF, LLC",500,10645,5110,5535
West,DEF,4/10/2005,RST S.A.,600,13962,6132,7830
Central,XYZ,4/10/2005,"OPQ, INC.",300,7305,3066,4239
East,DEF,4/10/2005,TUV GMBH,500,11845,4920,6925
West,XYZ,4/10/2005,"DEF, LLC",200,5002,2044,2958
Central,ABC,4/11/2005,TUV GMBH,100,1795,847,948
Central,DEF,4/11/2005,XYZ S.A.,800,16784,7872,8912
West,DEF,4/12/2005,QRS INC.,700,15834,7154,8680
Central,DEF,4/13/2005,EFG S.A.,500,12270,4920,7350
Central,ABC,4/14/2005,FGH LTD.,1000,17200,8470,8730
East,DEF,4/14/2005,EFG S.A.,400,8592,3936,4656
East,XYZ,4/14/2005,HIJ GMBH,300,6156,2541,3615
East,DEF,4/14/2005,QRS INC.,500,10445,4235,6210
West,DEF,4/15/2005,TUV GMBH,700,13867,6888,6979
Central,ABC,4/15/2005,LMN PTY LTD,600,10602,5082,5520
Central,XYZ,4/16/2005,"OPQ, INC.",300,5847,2541,3306
East,XYZ,4/17/2005,FGH LTD.,100,2095,1022,1073
East,DEF,4/17/2005,TUV GMBH,600,12690,5904,6786
Central,ABC,4/17/2005,TUV GMBH,500,9350,4235,5115
West,DEF,4/17/2005,EFG S.A.,300,6582,2952,3630
West,DEF,4/18/2005,FGH LTD.,600,13728,5904,7824
Central,XYZ,4/18/2005,"WXY, CO",900,22014,9198,12816
Central,DEF,4/18/2005,"WXY, CO",400,9672,3936,5736
Central,DEF,4/19/2005,LMN PTY LTD,600,10602,5082,5520
West,XYZ,4/19/2005,"DEF, LLC",1000,18530,8470,10060
Central,ABC,4/19/2005,"WXY, CO",900,17712,7623,10089
Central,DEF,4/19/2005,"OPQ, INC.",1000,23080,9840,13240
Central,DEF,4/19/2005,"OPQ, INC.",600,14004,5904,8100
West,ABC,4/20/2005,"OPQ, INC.",800,13552,6776,6776
East,XYZ,4/20/2005,"DEF, LLC",800,14984,6776,8208
East,ABC,4/20/2005,"OPQ, INC.",700,13139,5929,7210
West,DEF,4/20/2005,"OPQ, INC.",600,13200,5904,7296
Central,XYZ,4/21/2005,FGH LTD.,600,12480,6132,6348
Central,ABC,4/21/2005,HIJ GMBH,500,8715,4235,4480
East,ABC,4/22/2005,LMN PTY LTD,900,15759,7623,8136
East,DEF,4/22/2005,FGH LTD.,500,11435,4920,6515
West,DEF,4/23/2005,"WXY, CO",500,11220,4920,6300
Central,ABC,4/23/2005,"OPQ, INC.",700,14133,5929,8204
East,DEF,4/23/2005,"WXY, CO",600,14580,5904,8676
East,ABC,4/24/2005,LMN PTY LTD,400,6944,3388,3556
East,DEF,4/24/2005,RST S.A.,600,11922,5082,6840
East,DEF,4/24/2005,"WXY, CO",200,4866,1968,2898
West,XYZ,4/25/2005,"JKL, CO",300,5508,2541,2967
East,ABC,4/25/2005,QRS INC.,100,1877,847,1030
East,XYZ,4/25/2005,"DEF, LLC",700,14105,5929,8176
West,XYZ,4/25/2005,"OPQ, INC.",500,12760,5110,7650
Central,XYZ,4/26/2005,QRS INC.,400,8128,3388,4740
East,XYZ,4/27/2005,QRS INC.,400,9152,4088,5064
West,XYZ,4/27/2005,"OPQ, INC.",1000,24070,10220,13850
East,XYZ,4/28/2005,"DEF, LLC",400,6860,3388,3472
West,XYZ,4/28/2005,XYZ S.A.,800,16936,8176,8760
East,DEF,4/28/2005,FGH LTD.,200,4186,1968,2218
West,DEF,4/29/2005,TUV GMBH,600,10290,5082,5208
East,XYZ,4/29/2005,"OPQ, INC.",700,15715,7154,8561
East,ABC,4/29/2005,"JKL, CO",700,13195,5929,7266
East,ABC,4/29/2005,LMN PTY LTD,800,15640,6776,8864
East,DEF,4/29/2005,HIJ GMBH,700,16765,6888,9877
West,DEF,4/29/2005,"WXY, CO",500,12505,5110,7395
Central,XYZ,4/29/2005,TUV GMBH,300,7245,2952,4293
East,XYZ,4/30/2005,LMN PTY LTD,800,18208,8176,10032
Central,ABC,4/30/2005,"WXY, CO",200,3922,1694,2228
East,DEF,4/30/2005,RST PTY LTD,100,2358,984,1374
Central,ABC,4/30/2005,XYZ S.A.,800,20408,8176,12232
Central,DEF,5/1/2005,HIJ GMBH,1000,23970,9840,14130
East,XYZ,5/2/2005,EFG S.A.,400,8560,4088,4472
West,ABC,5/2/2005,"OPQ, INC.",800,17416,7872,9544
West,ABC,5/2/2005,"OPQ, INC.",700,17213,6888,10325
West,ABC,5/3/2005,VWX PTY LTD,500,8940,4235,4705
West,DEF,5/3/2005,FGH LTD.,600,13290,6132,7158
West,XYZ,5/3/2005,"OPQ, INC.",400,9204,4088,5116
West,DEF,5/4/2005,EFG S.A.,1000,20190,9840,10350
Central,DEF,5/4/2005,"WXY, CO",500,8970,4235,4735
Central,ABC,5/4/2005,"OPQ, INC.",800,17944,7872,10072
West,XYZ,5/4/2005,"DEF, LLC",200,5002,2044,2958
West,XYZ,5/5/2005,MNO CORP,300,7032,3066,3966
West,ABC,5/6/2005,LMN PTY LTD,700,13797,6888,6909
West,ABC,5/6/2005,RST S.A.,1000,17190,8470,8720
East,XYZ,5/6/2005,QRS INC.,400,7180,3388,3792
Central,DEF,5/6/2005,"WXY, CO",600,12888,5904,6984
Central,DEF,5/7/2005,"WXY, CO",500,8785,4235,4550
East,XYZ,5/7/2005,LMN PTY LTD,100,2517,1022,1495
Central,XYZ,5/8/2005,"DEF, LLC",500,10550,5110,5440
East,XYZ,5/8/2005,TUV GMBH,900,21042,9198,11844
Central,DEF,5/8/2005,EFG S.A.,500,11530,4920,6610
East,ABC,5/8/2005,HIJ GMBH,700,14133,5929,8204
Central,XYZ,5/9/2005,"DEF, LLC",300,6495,3066,3429
Central,ABC,5/9/2005,LMN INC.,800,15312,6776,8536
East,XYZ,5/10/2005,"JKL, CO",900,19161,9198,9963
Central,ABC,5/10/2005,LMN PTY LTD,400,7520,3388,4132
East,XYZ,5/11/2005,LMN PTY LTD,500,10940,5110,5830
Central,DEF,5/11/2005,EFG S.A.,600,14448,6132,8316
East,XYZ,5/11/2005,"DEF, LLC",500,11860,4920,6940
Central,ABC,5/12/2005,LMN PTY LTD,800,14136,6776,7360
West,XYZ,5/12/2005,TUV GMBH,900,21834,9198,12636
Central,ABC,5/12/2005,QRS INC.,1000,21010,8470,12540
Central,DEF,5/13/2005,TUV GMBH,600,10404,5082,5322
East,DEF,5/13/2005,EFG S.A.,500,9855,4235,5620
Central,DEF,5/13/2005,TUV GMBH,400,9660,4088,5572
Central,DEF,5/13/2005,HIJ GMBH,700,17367,7154,10213
East,DEF,5/14/2005,"WXY, CO",700,13797,6888,6909
Central,DEF,5/14/2005,LMN PTY LTD,200,4484,1968,2516
Central,DEF,5/14/2005,UVW INC.,500,11220,4920,6300
East,ABC,5/14/2005,FGH LTD.,800,16008,6776,9232
East,ABC,5/14/2005,HIJ GMBH,900,18576,7623,10953
Central,DEF,5/14/2005,"WXY, CO",500,12755,5110,7645
East,ABC,5/15/2005,LMN PTY LTD,700,12131,5929,6202
East,DEF,5/15/2005,"OPQ, INC.",1000,23040,9840,13200
East,DEF,5/16/2005,QRS INC.,700,15407,6888,8519
East,DEF,5/16/2005,HIJ GMBH,400,9672,3936,5736
Central,ABC,5/17/2005,TUV GMBH,800,16016,7872,8144
West,XYZ,5/17/2005,"DEF, LLC",500,10955,4920,6035
Central,XYZ,5/17/2005,"DEF, LLC",500,11250,4920,6330
Central,XYZ,5/17/2005,"DEF, LLC",900,21762,9198,12564
West,ABC,5/17/2005,XYZ S.A.,800,18904,7872,11032
Central,DEF,5/18/2005,"WXY, CO",400,6880,3388,3492
West,DEF,5/18/2005,HIJ GMBH,400,9064,4088,4976
Central,DEF,5/18/2005,LMN PTY LTD,500,11430,4920,6510
West,ABC,5/18/2005,MNO CORP,800,15976,6776,9200
Central,XYZ,5/19/2005,"DEF, LLC",800,15976,6776,9200
West,DEF,5/19/2005,QRS INC.,700,16408,6888,9520
East,ABC,5/20/2005,UVW INC.,700,14560,6888,7672
East,DEF,5/20/2005,QRS INC.,400,8804,4088,4716
East,DEF,5/20/2005,VWX PTY LTD,500,12135,5110,7025
East,DEF,5/20/2005,QRS INC.,500,10385,4235,6150
East,XYZ,5/21/2005,FGH LTD.,100,2234,1022,1212
West,ABC,5/21/2005,"JKL, CO",700,15876,7154,8722
Central,DEF,5/21/2005,EFG S.A.,600,11598,5082,6516
East,DEF,5/22/2005,LMN PTY LTD,1000,20540,9840,10700
Central,XYZ,5/23/2005,"JKL, CO",100,2092,1022,1070
East,ABC,5/23/2005,XYZ S.A.,700,13139,5929,7210
Central,ABC,5/23/2005,"WXY, CO",500,9475,4235,5240
East,XYZ,5/23/2005,"DEF, LLC",600,13818,6132,7686
East,DEF,5/23/2005,TUV GMBH,400,9760,3936,5824
Central,XYZ,5/24/2005,FGH LTD.,100,2343,1022,1321
Central,DEF,5/24/2005,QRS INC.,600,14178,6132,8046
Central,ABC,5/26/2005,TUV GMBH,800,18264,8176,10088
West,XYZ,5/27/2005,VWX PTY LTD,600,12612,6132,6480
East,XYZ,5/27/2005,"WXY, CO",500,10645,5110,5535
West,DEF,5/27/2005,HIJ GMBH,400,7376,3388,3988
West,ABC,5/28/2005,BCD LTD.,800,15104,6776,8328
Central,ABC,5/28/2005,EFG S.A.,800,19376,8176,11200
East,ABC,5/28/2005,"WXY, CO",400,8468,3388,5080
West,ABC,5/29/2005,EFG S.A.,700,17199,7154,10045
West,DEF,5/30/2005,"GHI, CO",600,11628,5082,6546
Central,DEF,5/30/2005,XYZ GMBH,500,12550,5110,7440
West,XYZ,5/31/2005,"DEF, LLC",700,16576,7154,9422
West,ABC,5/31/2005,LMN PTY LTD,400,8196,3388,4808
Central,DEF,5/31/2005,EFG S.A.,500,12425,5110,7315
East,XYZ,6/1/2005,FGH LTD.,700,17059,7154,9905
East,ABC,6/3/2005,HIJ GMBH,800,14224,6776,7448
West,DEF,6/3/2005,QRS INC.,500,11250,4920,6330
West,DEF,6/3/2005,LMN PTY LTD,500,11295,4920,6375
East,ABC,6/3/2005,LMN PTY LTD,700,16219,6888,9331
Central,XYZ,6/3/2005,"DEF, LLC",500,10245,4235,6010
East,DEF,6/5/2005,"OPQ, INC.",700,14784,6888,7896
West,XYZ,6/5/2005,"JKL, CO",800,19376,8176,11200
East,DEF,6/5/2005,"WXY, CO",600,14466,5904,8562
Central,DEF,6/5/2005,LMN PTY LTD,800,19424,7872,11552
West,DEF,6/6/2005,QRS INC.,1000,21740,9840,11900
East,ABC,6/6/2005,EFG S.A.,800,18208,8176,10032
East,DEF,6/6/2005,"WXY, CO",500,10295,4235,6060
Central,ABC,6/7/2005,TUV GMBH,900,15255,7623,7632
Central,ABC,6/7/2005,"OPQ, INC.",500,8970,4235,4735
East,DEF,6/7/2005,QRS INC.,900,19674,8856,10818
Central,DEF,6/7/2005,HIJ GMBH,900,21033,8856,12177
West,ABC,6/8/2005,XYZ GMBH,1000,17250,8470,8780
Central,DEF,6/8/2005,QRS INC.,600,12282,5904,6378
East,DEF,6/8/2005,QRS INC.,600,14004,5904,8100
Central,XYZ,6/9/2005,FGH LTD.,600,13680,6132,7548
Central,DEF,6/9/2005,FGH LTD.,600,13200,5904,7296
Central,DEF,6/9/2005,QRS INC.,700,13734,5929,7805
East,ABC,6/10/2005,RST PTY LTD,800,16784,7872,8912
Central,XYZ,6/11/2005,"DEF, LLC",500,8725,4235,4490
East,XYZ,6/11/2005,"DEF, LLC",500,10935,5110,5825
East,DEF,6/11/2005,LMN PTY LTD,800,17136,7872,9264
West,ABC,6/12/2005,"OPQ, INC.",400,6880,3388,3492
Central,ABC,6/12/2005,LMN INC.,800,17496,8176,9320
West,ABC,6/12/2005,"WXY, CO",200,3672,1694,1978
East,XYZ,6/12/2005,LMN LTD.,1000,24420,10220,14200
West,DEF,6/13/2005,FGH LTD.,500,11330,4920,6410
Central,XYZ,6/13/2005,"DEF, LLC",600,13728,5904,7824
Central,DEF,6/13/2005,LMN PTY LTD,300,7053,2952,4101
West,ABC,6/13/2005,"WXY, CO",800,16696,6776,9920
East,XYZ,6/14/2005,"DEF, LLC",700,11858,5929,5929
Central,ABC,6/14/2005,"WXY, CO",900,17757,8856,8901
West,DEF,6/14/2005,LMN PTY LTD,700,14469,7154,7315
West,XYZ,6/14/2005,"DEF, LLC",200,4412,1968,2444
Central,DEF,6/14/2005,LMN LTD.,500,11550,4920,6630
West,XYZ,6/14/2005,"DEF, LLC",500,10155,4235,5920
East,DEF,6/14/2005,"OPQ, INC.",600,12318,5082,7236
Central,DEF,6/15/2005,HIJ GMBH,600,13680,6132,7548
Central,ABC,6/15/2005,"JKL, CO",900,17136,7623,9513
East,DEF,6/15/2005,LMN PTY LTD,400,9484,3936,5548
West,DEF,6/15/2005,LMN PTY LTD,100,2410,984,1426
West,DEF,6/16/2005,"JKL, CO",600,12030,5904,6126
East,DEF,6/16/2005,LMN PTY LTD,400,8204,3936,4268
Central,DEF,6/16/2005,"JKL, CO",300,6462,2952,3510
West,XYZ,6/17/2005,XYZ GMBH,400,8556,4088,4468
West,ABC,6/17/2005,"OPQ, INC.",800,17856,8176,9680
East,XYZ,6/17/2005,CDE INC.,100,2538,1022,1516
Central,ABC,6/18/2005,FGH LTD.,800,18344,8176,10168
Central,DEF,6/19/2005,TUV GMBH,500,8715,4235,4480
East,ABC,6/19/2005,EFG S.A.,800,14216,6776,7440
East,ABC,6/19/2005,"JKL, CO",800,14408,6776,7632
Central,ABC,6/19/2005,"WXY, CO",800,17056,7872,9184
East,ABC,6/19/2005,EFG S.A.,700,16170,6888,9282
East,DEF,6/20/2005,"WXY, CO",500,9890,4920,4970
Central,DEF,6/20/2005,FGH LTD.,100,2004,984,1020
West,DEF,6/20/2005,LMN PTY LTD,400,8464,3936,4528
Central,XYZ,6/20/2005,FGH LTD.,500,11470,5110,6360
East,DEF,6/20/2005,FGH LTD.,500,11695,4920,6775
East,DEF,6/21/2005,TUV GMBH,600,14154,5904,8250
West,XYZ,6/21/2005,"WXY, CO",300,7569,3066,4503
Central,ABC,6/22/2005,"JKL, CO",300,5592,2541,3051
East,DEF,6/22/2005,"OPQ, INC.",800,19280,7872,11408
West,DEF,6/23/2005,EFG S.A.,200,3942,1968,1974
East,DEF,6/23/2005,"OPQ, INC.",500,11000,5110,5890
West,XYZ,6/23/2005,FGH LTD.,900,22887,9198,13689
West,ABC,6/24/2005,EFG S.A.,800,14136,6776,7360
Central,XYZ,6/24/2005,"DEF, LLC",1000,20840,9840,11000
East,XYZ,6/24/2005,"JKL, CO",600,13290,6132,7158
West,DEF,6/24/2005,LMN INC.,800,19344,7872,11472
Central,DEF,6/24/2005,QRS INC.,500,12095,4920,7175
East,ABC,6/24/2005,TUV GMBH,800,19520,7872,11648
Central,ABC,6/25/2005,LMN PTY LTD,800,17160,7872,9288
Central,DEF,6/26/2005,TUV GMBH,900,21546,8856,12690
Central,ABC,6/26/2005,LMN PTY LTD,800,16856,6776,10080
West,XYZ,6/27/2005,LMN PTY LTD,400,8284,4088,4196
West,DEF,6/27/2005,"OPQ, INC.",500,10295,4920,5375
Central,DEF,6/27/2005,QRS INC.,500,8940,4235,4705
West,XYZ,6/27/2005,QRS INC.,800,17496,8176,9320
East,DEF,6/27/2005,LMN INC.,500,10760,4920,5840
West,XYZ,6/27/2005,"UVW, INC.",800,19544,8176,11368
East,ABC,6/27/2005,"OPQ, INC.",900,18243,7623,10620
Central,DEF,6/27/2005,FGH LTD.,600,14154,5904,8250
West,ABC,6/28/2005,QRS INC.,800,16856,6776,10080
West,ABC,6/28/2005,LMN PTY LTD,900,22887,9198,13689
West,XYZ,6/29/2005,"DEF, LLC",800,15856,7872,7984
West,DEF,6/29/2005,"WXY, CO",700,13874,5929,7945
West,DEF,6/29/2005,FGH LTD.,1000,23690,9840,13850
Central,XYZ,6/30/2005,LMN PTY LTD,100,2309,1022,1287
West,XYZ,6/30/2005,"DEF, LLC",700,14105,5929,8176
Central,ABC,6/30/2005,EFG S.A.,100,2111,847,1264
East,XYZ,7/1/2005,HIJ GMBH,900,18756,9198,9558
West,DEF,7/1/2005,EFG S.A.,500,10990,5110,5880
Central,XYZ,7/1/2005,"DEF, LLC",500,9475,4235,5240
East,DEF,7/1/2005,"JKL, CO",500,11235,4920,6315
Central,XYZ,7/1/2005,VWX GMBH,400,9660,4088,5572
Central,ABC,7/1/2005,UVW INC.,900,21888,9198,12690
Central,ABC,7/2/2005,FGH LTD.,1000,17410,8470,8940
East,DEF,7/2/2005,TUV GMBH,700,12803,5929,6874
Central,DEF,7/2/2005,"WXY, CO",600,12888,5904,6984
West,XYZ,7/2/2005,"DEF, LLC",100,1878,847,1031
Central,DEF,7/2/2005,FGH LTD.,200,4492,1968,2524
East,DEF,7/3/2005,TUV GMBH,500,9890,4920,4970
East,ABC,7/3/2005,LMN PTY LTD,900,17136,7623,9513
East,DEF,7/3/2005,"WXY, CO",200,4696,1968,2728
East,DEF,7/4/2005,EFG S.A.,600,13206,5904,7302
East,ABC,7/4/2005,LMN PTY LTD,800,19424,7872,11552
Central,ABC,7/4/2005,EFG S.A.,100,2108,847,1261
East,DEF,7/5/2005,"JKL, CO",500,10295,4920,5375
East,XYZ,7/5/2005,"DEF, LLC",700,15435,7154,8281
West,DEF,7/6/2005,MNO CORP,600,13566,5904,7662
Central,XYZ,7/6/2005,"DEF, LLC",600,11964,5082,6882
East,XYZ,7/7/2005,QRS INC.,500,10380,5110,5270
East,XYZ,7/7/2005,EFG S.A.,300,6732,3066,3666
East,XYZ,7/7/2005,"DEF, LLC",900,20664,9198,11466
West,XYZ,7/7/2005,LMN PTY LTD,1000,25010,10220,14790
East,ABC,7/8/2005,QRS INC.,800,16232,7872,8360
East,XYZ,7/8/2005,EFG S.A.,300,6744,3066,3678
Central,ABC,7/8/2005,"WXY, CO",800,17544,7872,9672
Central,ABC,7/8/2005,"JKL, CO",800,16416,6776,9640
Central,XYZ,7/9/2005,"DEF, LLC",900,19503,8856,10647
Central,XYZ,7/10/2005,"DEF, LLC",900,15651,7623,8028
Central,DEF,7/10/2005,"OPQ, INC.",600,12984,6132,6852
Central,ABC,7/10/2005,QRS INC.,700,13552,5929,7623
East,ABC,7/11/2005,HIJ GMBH,600,11274,5082,6192
East,ABC,7/11/2005,FGH LTD.,700,13552,5929,7623
East,DEF,7/11/2005,EFG S.A.,500,11330,4920,6410
West,ABC,7/12/2005,QRS INC.,800,14408,6776,7632
West,XYZ,7/12/2005,"OPQ, INC.",800,18560,8176,10384
West,XYZ,7/13/2005,EFG S.A.,100,2213,1022,1191
West,DEF,7/13/2005,RST PTY LTD,700,15988,7154,8834
Central,XYZ,7/13/2005,"DEF, LLC",300,5847,2541,3306
East,ABC,7/14/2005,EFG S.A.,500,8725,4235,4490
Central,DEF,7/14/2005,FGH LTD.,500,9460,4235,5225
West,XYZ,7/14/2005,TUV GMBH,800,18304,8176,10128
East,DEF,7/15/2005,"WXY, CO",600,11124,5082,6042
Central,DEF,7/15/2005,"WXY, CO",700,13853,5929,7924
Central,XYZ,7/15/2005,"DEF, LLC",700,17199,7154,10045
West,XYZ,7/16/2005,"JKL, CO",900,18666,9198,9468
Central,ABC,7/16/2005,LMN PTY LTD,900,19539,9198,10341
East,ABC,7/16/2005,TUV GMBH,800,14440,6776,7664
Central,DEF,7/16/2005,"OPQ, INC.",600,11274,5082,6192
Central,ABC,7/16/2005,EFG S.A.,100,1968,847,1121
West,DEF,7/17/2005,"WXY, CO",500,10475,4920,5555
Central,XYZ,7/17/2005,"OPQ, INC.",200,4690,2044,2646
East,ABC,7/17/2005,"JKL, CO",100,2055,847,1208
Central,ABC,7/18/2005,HIJ GMBH,800,15816,7872,7944
West,XYZ,7/18/2005,"DEF, LLC",1000,22530,10220,12310
West,ABC,7/18/2005,VWX PTY LTD,800,15312,6776,8536
Central,XYZ,7/18/2005,"DEF, LLC",600,13368,5904,7464
Central,ABC,7/18/2005,"JKL, CO",700,15680,6888,8792
West,ABC,7/18/2005,LMN PTY LTD,900,21168,8856,12312
East,ABC,7/18/2005,HIJ GMBH,1000,20310,8470,11840
East,ABC,7/19/2005,CDE INC.,900,18756,9198,9558
West,DEF,7/19/2005,"OPQ, INC.",700,14560,6888,7672
East,DEF,7/19/2005,HIJ GMBH,700,12838,5929,6909
Central,ABC,7/19/2005,"WXY, CO",100,1861,847,1014
West,XYZ,7/19/2005,LMN LTD.,500,11680,5110,6570
East,XYZ,7/19/2005,"DEF, LLC",600,14178,6132,8046
Central,ABC,7/19/2005,LMN PTY LTD,900,21762,9198,12564
Central,ABC,7/20/2005,FGH LTD.,900,18666,9198,9468
East,XYZ,7/20/2005,HIJ GMBH,700,15225,7154,8071
Central,ABC,7/20/2005,TUV GMBH,500,9460,4235,5225
Central,ABC,7/21/2005,FGH LTD.,900,15363,7623,7740
Central,ABC,7/21/2005,FGH LTD.,600,10290,5082,5208
East,DEF,7/21/2005,"OPQ, INC.",600,11700,5082,6618
East,ABC,7/22/2005,FGH LTD.,800,17160,8176,8984
East,DEF,7/23/2005,FGH LTD.,600,12936,6132,6804
Central,ABC,7/24/2005,HIJ GMBH,800,16936,8176,8760
West,DEF,7/24/2005,EFG S.A.,700,13314,5929,7385
Central,ABC,7/25/2005,LMN PTY LTD,900,21015,9198,11817
Central,ABC,7/25/2005,LMN PTY LTD,900,21159,9198,11961
East,DEF,7/25/2005,QRS INC.,700,13986,5929,8057
West,ABC,7/25/2005,XYZ GMBH,900,22014,9198,12816
West,DEF,7/25/2005,FGH LTD.,700,16772,6888,9884
West,DEF,7/26/2005,FGH LTD.,600,11208,5082,6126
East,ABC,7/26/2005,"WXY, CO",900,21960,9198,12762
Central,DEF,7/27/2005,EFG S.A.,600,11430,5082,6348
East,ABC,7/27/2005,"OPQ, INC.",1000,25140,10220,14920
West,ABC,7/29/2005,EFG S.A.,1000,17200,8470,8730
East,ABC,7/29/2005,"OPQ, INC.",800,15400,6776,8624
West,ABC,7/30/2005,TUV GMBH,900,21438,9198,12240
Central,ABC,7/31/2005,HIJ GMBH,900,18486,8856,9630
East,ABC,8/1/2005,LMN PTY LTD,800,15288,6776,8512
Central,ABC,8/1/2005,FGH LTD.,900,17712,7623,10089
Central,ABC,8/1/2005,"JKL, CO",900,17964,7623,10341
East,DEF,8/1/2005,"JKL, CO",600,12684,5082,7602
East,DEF,8/2/2005,XYZ GMBH,600,11964,5082,6882
West,ABC,8/4/2005,QRS INC.,1000,23090,10220,12870
East,ABC,8/5/2005,"WXY, CO",900,18099,8856,9243
Central,XYZ,8/6/2005,"DEF, LLC",700,14497,6888,7609
West,ABC,8/6/2005,"WXY, CO",900,21834,9198,12636
West,DEF,8/7/2005,UVW INC.,600,12612,6132,6480
Central,ABC,8/7/2005,"WXY, CO",1000,20480,9840,10640
East,ABC,8/8/2005,LMN PTY LTD,900,18990,8856,10134
Central,DEF,8/8/2005,VWX PTY LTD,600,12672,5904,6768
West,ABC,8/8/2005,"JKL, CO",900,19989,8856,11133
Central,ABC,8/9/2005,"JKL, CO",1000,20770,8470,12300
East,ABC,8/9/2005,TUV GMBH,800,19344,7872,11472
West,DEF,8/10/2005,HIJ GMBH,700,12474,5929,6545
East,XYZ,8/10/2005,"DEF, LLC",600,14004,5904,8100
Central,XYZ,8/11/2005,"DEF, LLC",800,14592,6776,7816
East,ABC,8/11/2005,FGH LTD.,900,21708,8856,12852
Central,ABC,8/12/2005,EFG S.A.,1000,19630,8470,11160
West,ABC,8/13/2005,LMN PTY LTD,1000,23820,9840,13980
East,DEF,8/13/2005,"OPQ, INC.",600,15006,6132,8874
East,ABC,8/14/2005,FGH LTD.,700,16576,7154,9422
West,ABC,8/14/2005,"WXY, CO",1000,23040,9840,13200
West,ABC,8/14/2005,VWX PTY LTD,900,22716,9198,13518
East,ABC,8/15/2005,HIJ GMBH,900,17505,7623,9882
Central,ABC,8/16/2005,QRS INC.,1000,17840,8470,9370
Central,DEF,8/18/2005,QRS INC.,700,14203,6888,7315
West,XYZ,8/18/2005,"DEF, LLC",800,17240,7872,9368
East,ABC,8/18/2005,"OPQ, INC.",800,18072,8176,9896
West,XYZ,8/18/2005,"DEF, LLC",900,17883,7623,10260
West,ABC,8/18/2005,QRS INC.,700,17059,7154,9905
Central,DEF,8/19/2005,"JKL, CO",600,12756,5904,6852
West,ABC,8/19/2005,RST S.A.,800,15104,6776,8328
Central,ABC,8/19/2005,MNO S.A.,800,18552,7872,10680
East,ABC,8/19/2005,FGH LTD.,800,19288,8176,11112
East,ABC,8/19/2005,"JKL, CO",800,16144,6776,9368
West,ABC,8/21/2005,BCD LTD.,700,12131,5929,6202
Central,DEF,8/23/2005,"FGH, CO",700,12145,5929,6216
East,ABC,8/24/2005,TUV GMBH,700,13433,5929,7504
East,ABC,8/25/2005,LMN PTY LTD,800,15488,6776,8712
East,ABC,8/26/2005,LMN PTY LTD,900,16209,7623,8586
East,DEF,8/26/2005,QRS INC.,700,17150,6888,10262
Central,XYZ,8/27/2005,"DEF, LLC",900,20403,8856,11547
West,ABC,8/28/2005,LMN INC.,1000,20940,10220,10720
East,ABC,8/28/2005,"WXY, CO",900,20610,8856,11754
Central,ABC,8/29/2005,FGH LTD.,900,15651,7623,8028
East,XYZ,8/30/2005,"DEF, LLC",1000,25350,10220,15130
Central,ABC,8/31/2005,"OPQ, INC.",800,16288,6776,9512
East,ABC,9/1/2005,LMN PTY LTD,800,16936,8176,8760
West,ABC,9/2/2005,QRS INC.,900,19593,9198,10395
East,ABC,9/2/2005,HIJ GMBH,800,19280,7872,11408
West,ABC,9/3/2005,HIJ GMBH,700,13195,5929,7266
West,ABC,9/4/2005,QRS INC.,1000,18500,8470,10030
East,ABC,9/6/2005,CDE INC.,700,16303,6888,9415
Central,ABC,9/7/2005,FGH LTD.,800,13936,6776,7160
Central,ABC,9/7/2005,"JKL, CO",900,19674,8856,10818
West,ABC,9/7/2005,QRS INC.,1000,24430,10220,14210
West,ABC,9/8/2005,"UVW, INC.",1000,20090,9840,10250
Central,ABC,9/8/2005,TUV GMBH,1000,20840,9840,11000
East,ABC,9/8/2005,"JKL, CO",1000,23810,10220,13590
Central,XYZ,9/9/2005,"DEF, LLC",1000,21120,8470,12650
East,ABC,9/10/2005,LMN PTY LTD,900,21042,9198,11844
East,ABC,9/14/2005,TUV GMBH,1000,21730,9840,11890
East,ABC,9/18/2005,LMN INC.,1000,20490,10220,10270
Central,ABC,9/19/2005,"WXY, CO",800,16264,7872,8392
West,ABC,9/19/2005,LMN PTY LTD,1000,22810,10220,12590
West,ABC,9/19/2005,"WXY, CO",1000,19110,8470,10640
Central,ABC,9/20/2005,QRS INC.,700,14784,6888,7896
East,ABC,9/20/2005,QRS INC.,800,18504,7872,10632
Central,ABC,9/20/2005,"WXY, CO",800,20008,8176,11832
West,ABC,9/21/2005,"OPQ, INC.",800,15544,6776,8768
Central,ABC,9/22/2005,FGH LTD.,900,15759,7623,8136
East,ABC,9/22/2005,QRS INC.,900,17289,7623,9666
West,ABC,9/22/2005,EFG S.A.,800,15592,6776,8816
East,XYZ,9/23/2005,"DEF, LLC",900,18918,9198,9720
West,ABC,9/23/2005,QRS INC.,700,15715,7154,8561
Central,ABC,9/24/2005,"WXY, CO",1000,20540,9840,10700
East,ABC,9/24/2005,"WXY, CO",800,16936,7872,9064
Central,XYZ,9/25/2005,"DEF, LLC",1000,20020,9840,10180
Central,ABC,9/26/2005,"JKL, CO",700,15225,7154,8071
West,XYZ,9/26/2005,"DEF, LLC",1000,23990,10220,13770
Central,ABC,9/27/2005,LMN PTY LTD,800,17728,8176,9552
East,ABC,9/28/2005,"WXY, CO",1000,22020,10220,11800
West,XYZ,9/28/2005,"DEF, LLC",900,21033,8856,12177
West,ABC,9/30/2005,TUV GMBH,1000,18530,8470,10060
East,ABC,9/30/2005,LMN PTY LTD,800,18560,8176,10384
Central,XYZ,9/30/2005,"DEF, LLC",1000,25080,10220,14860
East,ABC,10/1/2005,"WXY, CO",900,15363,7623,7740
Central,ABC,10/1/2005,QRS INC.,800,18304,8176,10128
East,ABC,10/2/2005,TUV GMBH,800,15856,7872,7984
West,ABC,10/3/2005,FGH LTD.,900,15255,7623,7632
Central,ABC,10/5/2005,"OPQ, INC.",900,19368,9198,10170
Central,XYZ,10/5/2005,"DEF, LLC",800,17136,7872,9264
East,ABC,10/8/2005,FGH LTD.,900,17172,7623,9549
East,ABC,10/8/2005,EFG S.A.,1000,23080,9840,13240
East,ABC,10/10/2005,"OPQ, INC.",900,18684,9198,9486
Central,ABC,10/10/2005,FGH LTD.,1000,25310,10220,15090
Central,XYZ,10/15/2005,"DEF, LLC",900,18783,9198,9585
West,ABC,10/15/2005,XYZ GMBH,900,20664,9198,11466
East,ABC,10/15/2005,"OPQ, INC.",900,21456,9198,12258
West,XYZ,10/16/2005,"DEF, LLC",900,21357,8856,12501
Central,ABC,10/17/2005,LMN PTY LTD,1000,20950,9840,11110
East,ABC,10/18/2005,"OPQ, INC.",1000,19250,8470,10780
Central,ABC,10/18/2005,LMN PTY LTD,900,21465,9198,12267
East,ABC,10/18/2005,"JKL, CO",1000,21010,8470,12540
Central,ABC,10/20/2005,FGH LTD.,1000,18290,8470,9820
East,ABC,10/20/2005,EFG S.A.,1000,22840,10220,12620
West,ABC,10/20/2005,FGH LTD.,1000,20250,8470,11780
Central,ABC,10/22/2005,"OPQ, INC.",1000,17190,8470,8720
West,ABC,10/22/2005,"OPQ, INC.",1000,17250,8470,8780
West,ABC,10/24/2005,FGH LTD.,800,19152,8176,10976
Central,XYZ,10/24/2005,"DEF, LLC",800,19544,8176,11368
East,ABC,10/25/2005,"WXY, CO",900,19584,9198,10386
West,XYZ,10/28/2005,"DEF, LLC",800,16008,6776,9232
East,ABC,11/1/2005,EFG S.A.,1000,23890,10220,13670
East,ABC,11/3/2005,LMN PTY LTD,800,13552,6776,6776
Central,ABC,11/3/2005,"JKL, CO",900,21546,8856,12690
West,ABC,11/4/2005,EFG S.A.,1000,19890,8470,11420
East,ABC,11/7/2005,"JKL, CO",1000,22140,9840,12300
West,ABC,11/9/2005,LMN PTY LTD,900,21555,8856,12699
Central,ABC,11/10/2005,TUV GMBH,900,18981,7623,11358
East,ABC,11/11/2005,HIJ GMBH,1000,23690,9840,13850
Central,ABC,11/11/2005,VWX GMBH,1000,25060,10220,14840
West,ABC,11/17/2005,"OPQ, INC.",900,18576,7623,10953
East,ABC,11/18/2005,LMN LTD.,900,19161,9198,9963
Central,ABC,11/18/2005,FGH LTD.,900,18072,7623,10449
Central,XYZ,11/20/2005,"DEF, LLC",1000,24070,10220,13850
East,ABC,11/23/2005,FGH LTD.,900,21366,9198,12168
West,ABC,11/29/2005,BCD LTD.,900,19062,9198,9864
Central,ABC,11/30/2005,EFG S.A.,1000,20670,10220,10450
West,ABC,11/30/2005,FGH LTD.,1000,21880,10220,11660
East,XYZ,12/2/2005,"DEF, LLC",1000,21740,9840,11900
Central,ABC,12/4/2005,TUV GMBH,1000,22680,10220,12460
West,ABC,12/10/2005,"JKL, CO",1000,20190,9840,10350
East,ABC,12/19/2005,QRS INC.,1000,24130,10220,13910
Central,ABC,12/20/2005,FGH LTD.,1000,17410,8470,8940
West,ABC,12/20/2005,LMN PTY LTD,1000,18660,8470,10190
East,ABC,12/20/2005,LMN PTY LTD,900,18243,7623,10620
East,ABC,12/24/2005,HIJ GMBH,1000,21800,9840,11960
Central,XYZ,12/29/2005,"DEF, LLC",1000,18290,8470,9820
West,ABC,1/1/2006,"OPQ, INC.",1000,19530,8470,11060
Central,ABC,1/2/2006,FGH LTD.,1000,25010,10220,14790
Central,ABC,1/6/2006,EFG S.A.,1000,23970,9840,14130
West,ABC,1/11/2006,LMN LTD.,1000,24420,10220,14200
